000000 1720274B 10103303 20232900 00332007
000010 4B10105E 3F2FEC03 20160F20 16010003
000020 0F200A4B 10105E3E 2000.... ........
000030 454F46.. ........ ........ ........
000040 ........ ........ ........ ........
000050 ........ ........ ........ ........
000060 ........ ........ ........ ........
000070 ........ ........ ........ ........
000080 ........ ........ ........ ........
000090 ........ ........ ........ ........
0000A0 ........ ........ ........ ........
0000B0 ........ ........ ........ ........
0000C0 ........ ........ ........ ........
0000D0 ........ ........ ........ ........
0000E0 ........ ........ ........ ........
0000F0 ........ ........ ........ ........
000100 ........ ........ ........ ........
000110 ........ ........ ........ ........
000120 ........ ........ ........ ........
000130 ........ ........ ........ ........
000140 ........ ........ ........ ........
000150 ........ ........ ........ ........
000160 ........ ........ ........ ........
000170 ........ ........ ........ ........
000180 ........ ........ ........ ........
000190 ........ ........ ........ ........
0001A0 ........ ........ ........ ........
0001B0 ........ ........ ........ ........
0001C0 ........ ........ ........ ........
0001D0 ........ ........ ........ ........
0001E0 ........ ........ ........ ........
0001F0 ........ ........ ........ ........
000200 ........ ........ ........ ........
000210 ........ ........ ........ ........
000220 ........ ........ ........ ........
000230 ........ ........ ........ ........
000240 ........ ........ ........ ........
000250 ........ ........ ........ ........
000260 ........ ........ ........ ........
000270 ........ ........ ........ ........
000280 ........ ........ ........ ........
000290 ........ ........ ........ ........
0002A0 ........ ........ ........ ........
0002B0 ........ ........ ........ ........
0002C0 ........ ........ ........ ........
0002D0 ........ ........ ........ ........
0002E0 ........ ........ ........ ........
0002F0 ........ ........ ........ ........
000300 ........ ........ ........ ........
000310 ........ ........ ........ ........
000320 ........ ........ ........ ........
000330 ........ ........ ........ ........
000340 ........ ........ ........ ........
000350 ........ ........ ........ ........
000360 ........ ........ ........ ........
000370 ........ ........ ........ ........
000380 ........ ........ ........ ........
000390 ........ ........ ........ ........
0003A0 ........ ........ ........ ........
0003B0 ........ ........ ........ ........
0003C0 ........ ........ ........ ........
0003D0 ........ ........ ........ ........
0003E0 ........ ........ ........ ........
0003F0 ........ ........ ........ ........
000400 ........ ........ ........ ........
000410 ........ ........ ........ ........
000420 ........ ........ ........ ........
000430 ........ ........ ........ ........
000440 ........ ........ ........ ........
000450 ........ ........ ........ ........
000460 ........ ........ ........ ........
000470 ........ ........ ........ ........
000480 ........ ........ ........ ........
000490 ........ ........ ........ ........
0004A0 ........ ........ ........ ........
0004B0 ........ ........ ........ ........
0004C0 ........ ........ ........ ........
0004D0 ........ ........ ........ ........
0004E0 ........ ........ ........ ........
0004F0 ........ ........ ........ ........
000500 ........ ........ ........ ........
000510 ........ ........ ........ ........
000520 ........ ........ ........ ........
000530 ........ ........ ........ ........
000540 ........ ........ ........ ........
000550 ........ ........ ........ ........
000560 ........ ........ ........ ........
000570 ........ ........ ........ ........
000580 ........ ........ ........ ........
000590 ........ ........ ........ ........
0005A0 ........ ........ ........ ........
0005B0 ........ ........ ........ ........
0005C0 ........ ........ ........ ........
0005D0 ........ ........ ........ ........
0005E0 ........ ........ ........ ........
0005F0 ........ ........ ........ ........
000600 ........ ........ ........ ........
000610 ........ ........ ........ ........
000620 ........ ........ ........ ........
000630 ........ ........ ........ ........
000640 ........ ........ ........ ........
000650 ........ ........ ........ ........
000660 ........ ........ ........ ........
000670 ........ ........ ........ ........
000680 ........ ........ ........ ........
000690 ........ ........ ........ ........
0006A0 ........ ........ ........ ........
0006B0 ........ ........ ........ ........
0006C0 ........ ........ ........ ........
0006D0 ........ ........ ........ ........
0006E0 ........ ........ ........ ........
0006F0 ........ ........ ........ ........
000700 ........ ........ ........ ........
000710 ........ ........ ........ ........
000720 ........ ........ ........ ........
000730 ........ ........ ........ ........
000740 ........ ........ ........ ........
000750 ........ ........ ........ ........
000760 ........ ........ ........ ........
000770 ........ ........ ........ ........
000780 ........ ........ ........ ........
000790 ........ ........ ........ ........
0007A0 ........ ........ ........ ........
0007B0 ........ ........ ........ ........
0007C0 ........ ........ ........ ........
0007D0 ........ ........ ........ ........
0007E0 ........ ........ ........ ........
0007F0 ........ ........ ........ ........
000800 ........ ........ ........ ........
000810 ........ ........ ........ ........
000820 ........ ........ ........ ........
000830 ........ ........ ........ ........
000840 ........ ........ ........ ........
000850 ........ ........ ........ ........
000860 ........ ........ ........ ........
000870 ........ ........ ........ ........
000880 ........ ........ ........ ........
000890 ........ ........ ........ ........
0008A0 ........ ........ ........ ........
0008B0 ........ ........ ........ ........
0008C0 ........ ........ ........ ........
0008D0 ........ ........ ........ ........
0008E0 ........ ........ ........ ........
0008F0 ........ ........ ........ ........
000900 ........ ........ ........ ........
000910 ........ ........ ........ ........
000920 ........ ........ ........ ........
000930 ........ ........ ........ ........
000940 ........ ........ ........ ........
000950 ........ ........ ........ ........
000960 ........ ........ ........ ........
000970 ........ ........ ........ ........
000980 ........ ........ ........ ........
000990 ........ ........ ........ ........
0009A0 ........ ........ ........ ........
0009B0 ........ ........ ........ ........
0009C0 ........ ........ ........ ........
0009D0 ........ ........ ........ ........
0009E0 ........ ........ ........ ........
0009F0 ........ ........ ........ ........
000A00 ........ ........ ........ ........
000A10 ........ ........ ........ ........
000A20 ........ ........ ........ ........
000A30 ........ ........ ........ ........
000A40 ........ ........ ........ ........
000A50 ........ ........ ........ ........
000A60 ........ ........ ........ ........
000A70 ........ ........ ........ ........
000A80 ........ ........ ........ ........
000A90 ........ ........ ........ ........
000AA0 ........ ........ ........ ........
000AB0 ........ ........ ........ ........
000AC0 ........ ........ ........ ........
000AD0 ........ ........ ........ ........
000AE0 ........ ........ ........ ........
000AF0 ........ ........ ........ ........
000B00 ........ ........ ........ ........
000B10 ........ ........ ........ ........
000B20 ........ ........ ........ ........
000B30 ........ ........ ........ ........
000B40 ........ ........ ........ ........
000B50 ........ ........ ........ ........
000B60 ........ ........ ........ ........
000B70 ........ ........ ........ ........
000B80 ........ ........ ........ ........
000B90 ........ ........ ........ ........
000BA0 ........ ........ ........ ........
000BB0 ........ ........ ........ ........
000BC0 ........ ........ ........ ........
000BD0 ........ ........ ........ ........
000BE0 ........ ........ ........ ........
000BF0 ........ ........ ........ ........
000C00 ........ ........ ........ ........
000C10 ........ ........ ........ ........
000C20 ........ ........ ........ ........
000C30 ........ ........ ........ ........
000C40 ........ ........ ........ ........
000C50 ........ ........ ........ ........
000C60 ........ ........ ........ ........
000C70 ........ ........ ........ ........
000C80 ........ ........ ........ ........
000C90 ........ ........ ........ ........
000CA0 ........ ........ ........ ........
000CB0 ........ ........ ........ ........
000CC0 ........ ........ ........ ........
000CD0 ........ ........ ........ ........
000CE0 ........ ........ ........ ........
000CF0 ........ ........ ........ ........
000D00 ........ ........ ........ ........
000D10 ........ ........ ........ ........
000D20 ........ ........ ........ ........
000D30 ........ ........ ........ ........
000D40 ........ ........ ........ ........
000D50 ........ ........ ........ ........
000D60 ........ ........ ........ ........
000D70 ........ ........ ........ ........
000D80 ........ ........ ........ ........
000D90 ........ ........ ........ ........
000DA0 ........ ........ ........ ........
000DB0 ........ ........ ........ ........
000DC0 ........ ........ ........ ........
000DD0 ........ ........ ........ ........
000DE0 ........ ........ ........ ........
000DF0 ........ ........ ........ ........
000E00 ........ ........ ........ ........
000E10 ........ ........ ........ ........
000E20 ........ ........ ........ ........
000E30 ........ ........ ........ ........
000E40 ........ ........ ........ ........
000E50 ........ ........ ........ ........
000E60 ........ ........ ........ ........
000E70 ........ ........ ........ ........
000E80 ........ ........ ........ ........
000E90 ........ ........ ........ ........
000EA0 ........ ........ ........ ........
000EB0 ........ ........ ........ ........
000EC0 ........ ........ ........ ........
000ED0 ........ ........ ........ ........
000EE0 ........ ........ ........ ........
000EF0 ........ ........ ........ ........
000F00 ........ ........ ........ ........
000F10 ........ ........ ........ ........
000F20 ........ ........ ........ ........
000F30 ........ ........ ........ ........
000F40 ........ ........ ........ ........
000F50 ........ ........ ........ ........
000F60 ........ ........ ........ ........
000F70 ........ ........ ........ ........
000F80 ........ ........ ........ ........
000F90 ........ ........ ........ ........
000FA0 ........ ........ ........ ........
000FB0 ........ ........ ........ ........
000FC0 ........ ........ ........ ........
000FD0 ........ ........ ........ ........
000FE0 ........ ........ ........ ........
000FF0 ........ ........ ........ ........
001000 ........ ........ ........ ........
001010 ........ ........ ........ ........
001020 ........ ........ ........ ........
001030 ......B4 10B400B4 4077201F E3201B33
001040 2FFADB20 15A00433 20095790 0033B850
001050 3B2FE913 10002D4F 0000F100 1000B410
001060 7710002D E3201233 2FFA5390 0033DF20
001070 08B8503B 2FEE4F00 0005.... ........